######## #########
#......###.......#############
#..d...|.|.......|......S....#
#......###.......###########.#
######## ####|####         #.#################
            #B#            #.|...............#
            #.#            #.###############.#
            #.#            #.#             #.# 
            #.#            #.#             #.################# ##############################################
            #.#            #.#             #............S....|.|............................................#
            #.#            #.#             #.################# #............................B...............#
            #.#            #.#             #.#                 ##############...............................#####
#############|##############|###############|#############                  #...................................#  
#.......................S................................#                  #...................................#  
#........h...............................S...............#                  #...................................#
#......................B.................................#                  #...................................#
#........s..........................................B....#                  #...................................#
#.............................S..........................#                  #...................................#
#.........B..............................................#                  ########....................#########
#........................................................#                         #....................#
#...........................D............................#                         #..........D.........# 
##########################################################                         ######################
