################ ################ ###########
#..............# #..............# #.........#
#..@........h..|.|..s...........|.|........u#
#..............# #..............# #.........#
################ #..............# ###########
                 #..............#
                 #.............B#
                 ################
